{

    "doors" : [
  
      { "x":192, "y":64, "width":16, "height":16,
        "destination_zone":"01", "destination_x":0, "destination_y":-1 }
  
    ],
  
    "columns":12,
    "rows"   :9,
  
    "graphical_map":[26,24,18,18,18,18,18,18,18,18,24,26,
                     11,25,25,25,25,25,25,25,25,25,25,17,
                     11,25,25,25,25,25,25,25,25,25,25,25,
                     11,25,25,25,25,25,25,25,25,25,25,25,
                     11,25,25,25,25,25,25,25,25,25,25,25,
                     18,6,6,6,6,2,15,3,25,27,25,1,
                     25,25,25,25,25,9,26,11,41,41,41,9,
                     42,42,42,42,42,9,26,26,2,2,2,26],
  
    "collision_map":[0,4,4,4,0,0,4,4,4,4,4,0,
                     6,0,0,0,12,6,0,0,0,0,0,12,
                     6,0,0,0,0,0,0,0,0,0,0,0,
                     6,0,0,0,0,0,0,0,0,0,0,0,
                     6,0,0,0,0,0,0,0,0,0,0,0,
                     8,5,5,5,5,5,5,5,0,2,0,9,
                     8,2,2,2,2,1,0,3,2,2,2,0,
                     0,0,0,0,0,0,0,0,0,0,0,0],

    "id":"00"
  
  }